NO ./3dcube/textures/Stone_tile_128x128.xpm
SO ./3dcube/textures/Vine_tile_128x128.xpm
WE ./3dcube/textures/Vine_Fancy_tile_128x128.xpm
EA ./3dcube/textures/Fancy_tile_128x128.xpm

F 200,200,200
C 100,100,100

111101
100001
100001
111111