NO ./3dcube/textures/Wood_Plank_Shelf_tile_128x128.xpm
SO ./3dcube/textures/Wood_Plank_Shelf_Hat_tile_128x128.xpm
WE ./3dcube/textures/Wood_Plank_tile_128x128.xpm
EA ./3dcube/textures/Wood_Plank_Banner_tile_128x128.xpm

F 200,200,200
C 100,100,100

111111
100001
10SE01
10NW01
100001
111111