EA ./nofile_goes_here
SO ./sofile_goes_here
WE ./wefile_goes_here
NO ../textures/Wood_Plank_tile_128x128.xpm

F 200,200,200
C 100,100,100

1111
10011111
1N01
1111