NO ./nofile_goes_here
SO ./sofile_goes_here
WE ./wefile_goes_here
EA ./eafile_goes_here

F 200,200,200
C 100,100,100

11111111111111111   
10000000000000001111
10S01110111111100001
100000101     100001
10001010111   100001
10011010001   100001
10101110001111100001
10100010000000000001
10001111110000101001
10001000010000101001
10000000011100101001
100111110000001010011111111111111
1001   1100001101101
1001   1100001000101
10011111000001111101
10000000100100000001
10001001100101111001
10101000000101  1001
10101001100101111001
10000000000000000011
11111111111111111111